. . . . . . . . . . . . . . . . . . . . . ####. . . . . . . 
. . . . . . . . . . . . . . . . . . . . . ####. . . . . . . 
. . . . . . . . . . . . . . . . . . . . . ####. . . . . . . 
. . . ####. . . . . . . . . . . . . . . . ####. . . . . . . 
. . . ####. . . . . . . . ####. . . . . . ####. . . . . . . 
. . . ####. . . . . . . . ####. . . . . . ##########. . . . 
. . . ####. . . . . . . . ####. . . . . . ##########. . . . 
. . . ####. . . . . . . . ####. . . . . . . . . . . . . . . 
. . . ####. . . . . . . . ####. . . . . . . . . . . . . . . 
. . . ####. . . . . . . . ####. . . . . . . . . . . . . . . 
. . . ####. . . . . . . . ####. . . . . . . . . . . . . . . 
. . . ####. . . . . . . . ####. . . . . . . . . . . . . . . 
. . . . . . . . . . . . . ####. . . . . . . . . . . . . . . 
. . . . . . . . . . . . . ####. . . . . . . . . . . . . . . 
. . . . . . . . . . . . . ####. . . . . . . . . . . . . . . 