.........................####..........
.........................####..........
.........................####..........
...####..................####..........
...####........####......####..........
...####........####......##########....
...####........####......##########....
...####........####....................
...####........####....................
...####........####....................
...####........####....................
...####........####....................
...............####....................
...............####....................
...............####....................